111111111111
1P1C0CC00CC1
10C0E1CCC111
111111111111
